11111111111111111
1000P0000C0000001
11C001000000C0011
11000000E00001001
11001110000100101
11110000000010011
11000000000000011
11111111111111111
