111111111111111111111111111111
1EEEEEEEEEEEEEEEEEEEEEEEEEEEE1
1E0P011111111111111111111100E1
1E01C0000CCCC000C0000CCCC100E1
1E01C0000000C000C0000000C100E1
1E01C0C00CCCC000C0C00CCCC100E1
1E01CCCC0C000000CCCC0C000100E1
1E0100C00CCCC00000C00CCCC100E1
1E01010101010101010101010100E1
1E01111111111111111111111100E1
1EEEEEEEEEEEEEEEEEEEEEEEEEEEE1
111111111111111111111111111111
