1111111111111111111111111111111111111111111111111
1P00000000C0000000C000000000000000000000000000001
1111111111111111111111111111111111111111111111001
10000000000000C0000000000000000000000000000000001
1001111111111111111111111111111111111111111111111
1000000000C0000000C000000000000000000000000000001
1111111111111111111111111111111111111111111111001
100000C000000000C00000000000000000000000000000001
1000000011111111111111111111111111111111111111111
11111000000C000000000C000000000000000000000000EE1
1C00000000000000000000000000000000000000000000EE1
1111111111111111111111111111111111111111111111111
