11111111111111111111111111111111111111111111111
10000000000000000000000000000000000000000000001
10000000000000000000000000000000000000000000001
1000000CCCCCCC00CCC00000CCCCCC000CCCCCC00000001
1000000000C0000C000C000C00000000C00000000000001
1000000000C000C00000C0C00000000C000000000000001
1000000000C000C00000C0C000CCCC0C000CCCC00000001
1000000000C0000C000C000C00000C00C00000C00000001
1000000000C00000CCC00000CCCCCC000CCCCCC00000001
10000000000000000000000000000000000000000000001
100000000000000000CCCC00CCCC0000000000000000001
100000000000000CCCC00000000CCCC0000000000000001
100000000000CCCC00000000000000CCCC0000000000001
100000000CCCC00000000000000000000CCCC0000000001
100000CCCC00000000000000000000000000CCCC0000001
100CCCC000000000000000P0000000000000000CCCC0001
100CCCC00000000000000000000000000000000CCCC0001
100000CCCC00000000000000000000000000CCCC0000001
100000000CCCC00000000000000000000CCCC0000000001
100000000000CCCC000000000000000CCCC000000000001
100000000000000CCCC00000000CCCC0000000000000001
100EEE00000000000CCCC00CCCC00000000000000000001
100E00000000000E0E0E0E0000000000000E0000EEEEE01
100EEE0EE000EE0EEE000E000EE000EE00E0E000000E001
100E000E0E0E0E00E00E0E000E0E0E0E0E0E0E0000E0001
100EEE0E00E00E00E00E0EEE0E00E00EE00000E0EEEEE01
11111111111111111111111111111111111111111111111
